0 : empty (we could possibly go here)
1 : wall
2 : dot
3 : power dot
4 : ghost house door
5 : portal
6 : bonus
b : blinky start position
p : pinky start position
i : inky start position
c : clyde start position
9 : start position

<!-- map -->

111111111111111111111
122222222212222222221
121112111212111211121
131012101212101210131
121112111212111211121
122222222222222222221
121112121111121211121
121112121111121211121
122222122212221222221
111112111010111211111
0000121000b0001210000
000012101141101210000
111112101i0c101211111
5000020010p0100200005
111112101111101211111
000012100060001210000
000012101111101210000
111112101111101211111
122222222212222222221
121112111212111211121
132212222292222212231
111212121111121212111
111212121111121212111
122222122212221222221
121111111212111111121
122222222222222222221
111111111111111111111
